00000000000000000000000000000000000000000000000000000000000
01011111111111111111011111111111111111110111111111110111110
01010000000001000101010000000000000000000100000000000000010
01011111111101011101111111111111111111111111111111111111010
01010000000000000000000000001010100000000000000000010000010
01010100101111111111111111101010101010101010111111010111110
01111111101000000100000000101010111111111011100000010100010
01010100001011111100111111101010000010100010111111010001010
00010101001010100000000000001010111110111110101010011111110
01110101111010101111111111101010100000000000000000000000000
00000101000000101000000000001000000111111111111111111111110
01111111111101111111101111101011111101000000000000000010100
00000000000000000000100000101000000101111101111111111110000
01111111111111111111111111101011111101010101000000000000100
00000000010000000000000000000000000001010101111111110111110
01111111111111111110111111111111110001010100000000010100010
00000000010000001000001000000000010001010100000000010111010
01111111111101111111101111111111010001010101111111110000010
00000000010000001000001000100001010001010100000000011111110
01111111110111111111111000000000011111000000000000000000000
